11111111
100001E1
100P0011
10000011
11111111