11111111
100000E1
100P0011
1C000011
11111111