111111111111111111
1001C1000000001P11
100010000E00000101
1000000C0000000001
111111111111111111